30 30
204  256  256  256  256  256  257  256  256  257  258  256  257  256  257  256  256  257  256  257  256  256  257  256  257  258  220  221  222  202
            231  11  12  13  1  1  1008  1  30  1  1  1  56  30  1  1  1  30  1  1  1  1  1  1  707  1  220  221  222  229
            231  38  39  37  1  1  1  1  1  1  1  1  1  1  1  1  30  1  1  1  1  1  1  1  1  1  247  248  249  229
            231  65  66  67  1  1  1  1  1  1  1  1  1  193  194  195  1  1  1  1  1  1  1  1  1  1  1  1  1  229
            231  1  1  1  1  1  1  1  1  1  30  1  1  220  221  222  1  1  1  1  1  1  1  193  194  195  1  1  1  229
            231  1  202  203  204  1  1  30  1  1  1  1  1  247  248  249  1  1  1  1  1  30  1  220  221  222  707  1  1  229
            231  1  229  230  231  1  1  1  56  1  1  1  1  1  1  1  707  1  1  1  1  1  1  247  248  249  1  1  1  229
            231  1  256  257  258  1  1  1  1  1  1  1  1  1  1  1  1  1  202  203  204  1  1  1  1  1  1  1  1  229
            231  1  1  707  1  1  1  1  56  1  1  1  30  1  1  1  1  1  229  230  231  1  1  1  1  1  1  1  56  229
            231  1  1  1  1  1  1  1  30  1  1  1  1  1  1  1  1  1  256  257  258  1  1  1  1  1  1  1  1  229
            231  30  1  1  1  1  1  1  1  1  1  1  1  193  194  195  1  1  1  1  1  1  1  278  279  280  1  1  1  229
            231  56  1  1  1  193  194  195  1  1  1  1  1  220  221  222  1  1  1  1  1  30  1  305  306  307  1  1  1  229
            231  1  1  1  1  220  221  222  1  1  1  30  1  247  248  249  1  1  1  1  1  1  1  332  333  334  1  1  56  229
            231  1  1  1  1  247  248  249  1  1  1  1  1  1  1  1  1  1  1  1  1  1  30  1  1  1  1  1  1  229
            231  278  279  280  1  1  1  1  1  1  30  1  1  1  1  1  1  1  1  56  1  1  1  1  1  1  1  1  1  229
            231  305  306  307  1  1  1  1  1  1  56  1  1  1  1  1  1  1  202  203  204  1  1  1  30  1  193  194  195  229
            231  332  333  334  1  1  1  1  56  1  1  1  1  1  56  1  1  1  229  230  231  1  1  1  1  1  220  221  222  229
            231  1  1  1  1  30  1  1  1  1  1  1  1  1  1  1  30  1  256  257  258  1  1  1  1  1  247  248  249  229
            231  1  202  203  204  1  1  1  1  1  193  194  195  1  1  1  1  1  1  1  1  193  194  195  1  1  1  1  1  229
            231  1  229  230  231  1  1  1  1  1  220  221  222  1  1  1  1  1  707  1  1  220  221  222  1  1  1  1  1  229
            231  1  256  257  258  1  1  1  1  1  247  248  249  1  1  1  1  1  1  1  1  247  248  249  1  1  1  56  30  229
            231  1  1  707  1  1  1  56  30  1  1  1  786  1  1  1  1  1  1  1  1  1  1  1  1  1  1  1  1  229
            231  1  1  1  1  1  1  1  1  1  1  1  1  1  1  1  1  1  1  1  1  30  1  1  1  1  202  203  204  229
            231  1  1  1  1  1  1  1  1  1  1  1  1  1  1  1  1  1  1  1  1  1  1  1  1  1  229  230  231  229
            231  1  30  1  1  193  194  195  1  1  30  1  1  1  1  1  30  1  193  194  195  1  1  56  1  1  256  257  258  256
            231  1  1  1  1  220  221  222  1  1  56  1  1  1  1  1  1  1  220  221  222  1  1  1  1  1  1  1  1  131
            230  203  204  1  1  247  248  249  1  1  1  1  1  1  1  1  1  1  247  248  249  1  1  1  1  1  1  1  1  131
            230  230  231  1  30  1  1  1  1  1  1  1  203  203  203  1  1  1  1  1  1  1  1  1  1  1  1  1  1  131
            230  230  231  1  1  56  1  1  1  1  1  707  230  230  230  1  1  1  1  1  1  56  30  1  1  1  1  1  1  202
            230  230  229  203  204  203  204  204  203  204  204  204  230  230  230  204  203  203  203  203  203  203  203  202  203  203  203  203  203  230