50 50
164   164   164   164   164   164   164   164   164   164   406   164   164   908   164   164   164   193   194   195   164   164   164   164   164   164   164   164   164   164   164   164   164   164   164   164   164   164   164   164   164   164   164   164   164   164   164   164   164   164
            195   1   1   11   12   13   1   1   1   1   406   1   1   1   1   1   786   220   221   222   1   1   1   1   1   1   1   1   1   1   1   968   969   36   36   1   1   1   1   1   1   786   1   1   1   1   1   1   1   721
            222   36   36   36   39   40   1   202   203   204   406   1   1   1   1   906   1   220   221   222   1   1   1   1   1   1   1   1   1   1   1   995   996   36   1   1   1   1   1   1   1   1   1   1   1   1   1   1   1   748
            222   1   1   65   36   67   1   229   230   231   406   1   1   1   1   1   1   220   221   222   1   1   1   1   1   1   1   1   1   1   1   1   1   36   1   202   203   204   1   1   1   1   1   1   1   1   1   1   1   748
            222   1   1   1   36   1   1   256   257   258   406   1   1   1   1015   1   1   220   221   222   1   1   1   1   1   1   1   1   1   1   1   1   36   36   1   229   230   231   1   1   202   203   204   1   1   202   203   204   1   748
            222   1   1   1   36   1   1   1   1   1   406   1   906   1   1   1   1   220   221   222   1   1   1   1   1   1   1   1   1   1   1   1   36   1   1   256   257   258   1   1   229   230   231   1   1   229   230   231   1   748
            354   354   354   354   848   354   354   354   354   354   436   1   1   1   1   1   1   220   221   222   1   1   1   1   202   203   204   786   1   1   1   1   36   36   1   1   1   1   1   1   256   257   258   1   1   256   257   258   1   748
            222   1   1   1   36   36   36   1   1   1   1   1   1   1   1   1   1   220   221   222   1   1   1   1   229   230   231   1   1   1   1   1   1   36   1   1   1   1   1   1   736   1   1   1   1   1   1   1   1   748
            221   194   194   194   194   195   36   818   1   1   1   1   1   1   1   1   1   220   221   222   1   1   1   1   256   257   258   736   1   1   1   1   1   36   1   1   1   1   1   1   1   1   1   1   1   1   1   1   1   748
            221   221   221   221   221   222   36   36   1   1   1   1   1   1   1   1   1   220   221   222   1   1   1   1   1   1   1   1   1   1   1   1   1   36   1   1   1   1   1   1   1   1   1   1   1   1   1   1   1   748
            221   221   221   221   221   222   1   36   1   1   194   194   194   194   194   194   194   221   221   221   194   194   194   194   194   195   1   1   1   1   1008   1   36   36   1   907   1   1   1   1   1   1   1   1   1   1   1   1   1   748
            221   221   221   221   221   222   36   36   193   194   221   221   221   221   221   221   221   221   221   221   221   221   221   221   221   221   194   1   1   1   36   36   36   1   1   1   1   1   788   1   1   1   1   1   1   1   1   1   1   717
            221   221   221   221   221   222   36   193   221   221   221   221   221   221   221   221   221   221   221   221   221   221   221   221   221   221   221   1   36   36   36   36   36   1   1   1   818   1   1   1   1   36   36   36   36   36   36   36   1   131
            221   221   221   221   221   222   36   220   221   221   221   221   221   221   221   221   221   221   221   221   221   221   221   222   249   249   249   36   36   36   1   1   36   36   36   36   36   36   36   36   36   36   1   1   1   1   1   36   36   131
            222   247   249   248   248   249   36   247   248   248   248   248   248   248   248   248   248   248   248   248   248   248   248   249   1   1   897   36   1   1   1   1   1   1   1   1   1   1   1   1   1   1   1   1   1   1   1   1   1   131
            678   678   678   678   678   678   848   279   279   279   279   279   279   279   279   279   279   279   279   279   279   279   279   279   279   1   1   36   36   1   1   1   1   1   1   1   1   1   1   1   1   1   1   1   1   1   1   1   1   131
            222   1   1   1   1   1   1   1   1   1   1   1   1   1   1   1   1   1   1   1   1   1   622   1   1   1   907   1   36   36   36   36   1   1   1   1   1   736   1   1   1   1   1   1   1   1   1   1   1   717
            222   1   1   278   354   355   1   353   678   678   678   678   678   678   523   1   359   462   462   462   462   462   388   1   1   1   202   203   204   1   1   36   36   1   1   1   1   1   1   1   202   203   204   1   1   1   1   1   1   744
            222   1   1   298   1   1   1   1   1   1   1   1   1   1   406   1   406   1   1   1   1   786   406   1   1   1   229   230   231   1   1   1   36   36   927   1   1   1   1   1   229   230   231   1   1   1   1   1   1   717
            222   1   1   298   1   271   1   353   354   354   354   280   1   1   406   1   406   1   406   1   440   354   436   1   1   1   256   257   258   1   766   1   1   36   36   1   1   1   1   1   256   257   258   1   1   1   1   1   202   203
            222   1   1   298   1   406   1   1   1   1   1   406   1   1   406   1   406   1   406   1   514   1   1   1   1   1   1   1   1   1   1   1   1   1   36   1   1   1   1   1   1   1   1   1   1   1   1   1   229   230
            222   1   1   298   1   406   1   271   1   379   1   406   1   1   406   1   298   1   406   1   514   1   1   1   1   1   1   1   1   1   1   1   1   1   36   36   1   1   1   1   1   1   1   1   1   1   1   1   256   257
            354   354   354   334   1   406   1   406   1   406   1   406   1   1   406   1   325   1   298   1   514   1   1   1   1   1   1   1   1   1   202   203   204   1   1   36   1   1   1   786   1   1   1   1   202   203   204   1   1   744
            222   1   1   1   1   406   1   406   1   406   1   406   1   1   406   1   1   1   298   1   514   1   1   1   1   1   1   1   1   1   229   230   231   1   1   36   1   202   203   204   1   1   1   1   229   230   231   1   1   744
            354   354   354   355   1   406   1   406   1   406   1   406   1   1   332   354   354   354   443   279   519   280   1   203   204   1   1   1   1   1   256   257   258   36   36   36   1   229   230   231   1   1   1   1   256   257   258   1   1   744
            222   1   1   1   1   332   279   334   1   406   1   406   1   1   1   1   1   1   467   468   306   307   1   230   231   1   1   1   1   1   1   36   36   36   1   1   1   256   257   258   1   1   1   1   1   1   1   1   1   744
            222   786   1   1   1   1   406   1   1   406   1   326   354   354   354   354   354   354   443   468   333   334   1   1   258   1   1   1   1   1   926   36   36   900   1   1   1   1   1   1   1   1   1   1   1   1   1   1   1   744
            354   354   462   354   354   354   333   354   354   436   1   1   1   1   1   1   1   1   1   406   1   1   1   1   1   1   1   1   1   847   36   36   36   36   36   36   896   1   1   1   1   1   1   1   1   1   1   1   1   744
            222   1   1   1   1   1   1   1   1   1   1   1   1   1   1   1   1   1   1   406   1   1   1   1   1   1   1   1   896   36   36   36   818   36   36   36   36   1   1   1   1   1   1   202   203   204   1   1   1   744
            354   354   848   354   354   354   354   354   354   354   354   354   354   354   354   354   354   354   354   436   1   1   736   1   1   1   1   1   1   36   36   36   1005   36   36   36   36   1   1   1   1   1   1   229   230   231   1   1   1   744
            222   1   1   1   1   1   1   1   1   1   1   1   1   1   1   1   1   1   1   1   1   1   1   1   1   1   1   1   1   36   36   36   36   36   36   954   36   36   1   1   1   1   1   256   257   258   1   1   1   744
            222   1   1   1   1   1   1   1   1   1   1   1   1   1   1   1   1   1   1   1004   1   1   1   1   1   1   1   1   36   36   36   36   954   202   203   204   36   36   896   1   1   1   1   1   1   1   1   1   1   744
            222   1   1   1   1   1   1   1   1   1   1   1   1   1   1   1   1007   36   36   36   36   1   1   1   1   1   1   1   36   896   36   36   1   229   230   231   1   1   1   1   1   1   766   1   1   1   1   1   1   744
            222   202   203   204   1   1   1   1   202   203   204   1   1   1   1   1   36   36   1   1   36   36   36   36   1   1   1   36   36   1   958   959   1   256   257   258   1   1   1   1   1   1   1   1   1   1   1   1   1   744
            222   229   230   231   1   1   1   1   229   230   231   1   1   766   1   36   36   1   1   1   1   1   1   36   36   36   36   36   36   36   985   986   1   1   1   1   1   1   1   1   1   1   1   1   1   1   1   1   1   744
            222   256   257   258   1   1   1   1   256   257   258   1   907   1   36   36   1   1   1   1   1   1   1   1   711   1   1   1   1   36   36   1009   1   1   1   1   1   1   1   1   1   1   1   1   1   1   1   1   1   744
            222   1   1   1   1   1   1   1   1   1   1   1   1   36   36   1006   1   1   1   1   1   1   1   1   1   1   1   1   1   1   36   36   935   766   961   1   1   1   1   1   1   1   1   1   1   1   1   1   1   744
            222   1   1   202   203   204   1   1   1   1   1   1   36   36   1   1   1   1   202   203   204   1   1   1   1   1   1   1   1   1   1   36   1   1   1   1   1   1   1   1   1   1   202   203   204   1   1   1   1   744
            222   1   1   229   230   231   1   1   1   1   1   847   36   1   791   1   1   1   229   230   231   1   1   1   1   1   1   1   1   1   1   36   36   36   1   1   1   761   1   1   1   1   229   230   231   1   1   1   1   744
            222   1   1   256   257   258   1   1   1   1   710   36   36   1   1   1   1   1   256   257   258   1   1   1   202   203   204   1   1   1   1   1   1   36   36   36   36   36   36   1   1   1   256   257   258   1   1   1   1   744
            222   1   1   1   1   1   1   1   1   1   1   36   1   1   1   1   1   1   1   1   1   1   1   1   229   230   231   1   1   1   1   1   766   1   1   1   1   1   36   36   36   36   36   36   36   1   1   1   1   717
            222   1   1   1   1   736   1   1   1   1   36   36   1   1   1   1   1   1   1   1   1   1   1   1   256   257   258   1   1   1   1   1   1   1   1   1   1   1   1   1   762   1   1   1   36   36   36   36   1   131
            222   1   1   1   1   1   1   1   1   1   36   1   1   1   1   1   1   1   1   1   1   1   1   1   1   1   1   202   203   204   1   1   1   1   1   1   1   1   1   1   1   1   1   1   1   1   1   36   36   131
            222   1   1   1   1   1   202   203   204   1   36   1   1   1   1   1   202   203   204   1   1   1   1   1   1   1   1   229   230   231   1   1   1   1   1   736   1   1   1   1   1   1   1   1   1   1   1   1   36   131
            222   1   202   203   204   1   229   230   231   1   36   907   1   1   1   1   229   230   231   1   1   1   1   1   1   1   1   256   257   258   1   1   1   1   1   1   1   1   1   1   202   203   204   1   1   1   1   1   1   131
            222   1   229   230   231   1   256   257   258   1   36   1   736   1   1   1   256   257   258   1   1   1   1   1   1   1   1   1   1   1   1   1   1   1   1   1   1   1   1   1   229   230   231   1   1   1   1   1   1   717
            222   786   256   257   258   1   1   1   1   1   36   1   1   1   1   1   1   1   786   1   1   1   1   1   1   1   1   1   1   1   1   1   1   1   1   1   1   1   1   1   256   257   258   1   1   1   1   1   1   744
            222   1   1   1   1   1   1   1   1   1   36   1   1   1   1   1   1   1   1   1   1   202   203   204   1   1   1   1   202   203   204   1   1   1   1   1   202   203   204   1   1   1   1   1   1   1   1   1   1   744
            222   1   1   1   1   1   1   1   1   1   36   1   1   1   1   1   1   1   1   1   1   229   230   231   1   1   1   1   229   230   231   1   1   1   1   1   229   230   231   1   1   1   1   1   1   1   1   1   1   744
            222   717   800   800   800   800   800   717   131   131   131   131   131   717   800   800   800   800   800   800   717   256   257   258   717   800   800   717   256   257   258   717   800   800   800   717   256   257   258   717   800   800   800   800   800   800   800   800   800   717