50 50
717   800   800   800   800   800   800   800   800   800   800   800   800   800   800   800   800   800   800   800   800   800   800   800   800   800   800   800   800   800   800   800   800   800   800   800   800   800   800   800   800   800   800   800   800   800   800   800   800   717
            744   11   12   13   1   1   1   1   1   1   1   1   1   1   1   1   1   1   1   1   1   1   1   1   1   1   1   1   1   1   1   1   1   1   1   906   1   1   1   1   1   1   1   908   1   1   1   1   1   744
            744   38   39   40   1   1   1   1   1   1   1   1   1   1   1   1   1   1   1   225   1   1   1   1   1   1   1   1   1   914   915   1   1   1   1   1   1   1   1   1   1   1   906   1   1   1   1   1   1   744
            744   65   66   67   745   800   800   800   800   800   800   800   800   800   800   800   717   800   800   800   800   800   717   1   1   717   1   1   1   941   942   1   1   1   1   1   1   1   1   1   1   1   1   1   1   1   906   1   1   744
            744   1   1   1   744   786   1   908   1   1   1   1   910   1   1   1   748   1   1   1   1   1   744   1   1   744   1   1   1   1   1   1   1   1   1   1   1   1   1   1   1   1   906   1   1   1   1   1   1   744
            744   1   1   1   744   1   1   1   1   1   1   1   1   1   1   1   748   1   1   1   1   1   744   786   1   744   1   1   1   1   1   906   1   1   819   1   1   1   1   1   1   1   1   1   1   1   1   1   1   744
            744   1   1   1   744   1   1   1   1014   1   914   915   1   1   1   934   748   1   1   717   1   1   717   722   722   717   1   1   717   800   800   800   800   800   717   1   1   1   1   717   800   800   800   800   800   800   800   800   800   717
            744   1   1   1   744   1   910   1   1   1   941   942   1   1   1   1   748   1   1   744   1   1   744   193   194   195   1   1   744   1   1   1   1   1   1   1   1   1   1   1   1   1   1   225   1   963   1   1   786   744
            744   1   1   1   744   1   1   1   1   1   1   1   1   1   1   1   748   1   1   744   1   1   744   220   221   222   1   1   744   1   1   1   1   1   1   1   1   1   1   1   1   1   1   1   1   1   1   1   1   744
            744   1   1   1   717   843   1   1   1   1   1   1   1   1   1   1   748   1   1   744   1   1   1   247   248   249   1   1   744   1   1   1   1   1   1   225   1   1   1   1   1   1   1   1   1   1   1   1   1   744
            744   1   1   1   1   1   1   1   1   1   1   1   1   911   1   1   748   1   1   744   1   1   1   1   1   1   1   1   744   1   1   1   1   1   1   1   1   1   1   1   1   1   1   1   1   1   962   1   1   744
            744   1   1   1   1   1   1   1   1   1   1   1   1   1   1   1   748   1   1   744   1   1   1   1   1   1   1   1   744   1   1   1   1   1   1   1   1   1   1   1   1   1   1   1   1   1   1   1   1   744
            744   1   1   225   717   1   1   906   1   1   1   1   225   1   1   1   717   1   1   717   800   800   800   800   717   1   1   1   717   1   1   962   963   1   1   1   1   1   1   225   1   1   1   1   1   1   1   1   1   744
            744   1   1   1   744   225   1   1   1   1   1   1   1   1   1   1   1   1   906   1   1   1   1   1   744   1   1   1   744   1   1   786   1   1   1   1   1   1   1   1   1   1   1   1   1   1   1   1   1   744
            744   1   1   1   744   1   1   1   1   1   1   1   1   911   1   1   1   1   1   1   1   1   1   1   912   913   1   1   744   1   1   1   1   1   912   913   1   1   1   1   1   1   1   1   912   913   1   1   1   744
            744   1   1   1   744   1   1   1   1   1   906   1   1   1   1   1   717   1   1   1   1   1   759   1   939   940   1   1   744   1   1   1   1   1   939   940   1   1   1   1   1   1   1   1   939   940   1   1   1   744
            744   1   1   1   744   1   1   1014   1   1   1   1   1   1   1   1   744   1   1   1   1   1   1   1   744   1   1   1   744   1   1   1   1   1   1   1   1   1   1   1   1   1   1   1   1   1   1   1   1   744
            744   225   1   1   744   1   911   1   1   1   1   1   1   1   1   1   744   1   1   1   1   1   1   1   744   1   1   1   744   968   969   1   1   1   1   1   1   1   1   1   1   1   1   1   1   1   1   1   1   744
            744   1   1   1   744   1   1   1   1   1   906   1   1   1   1   1   744   1   1   759   1   1   1   1   744   1   1   1   744   995   996   1   1   225   1   1   1   1   1   968   969   1   1   1   1   962   1   1   1   744
            744   1   1   1   717   800   800   800   800   800   800   800   800   800   800   800   717   1   1   1   1   1   1   1   717   800   800   800   717   1   1   1   1   1   1   1   1   1   1   995   996   1   1   1   1   1   225   1   1   744
            744   1   1   1   1   1   1   1   1   1   1   1   1   1   1   1   1   1   1   1   1   1   1   1   1   1   1   1   1   1   1   1   1   1   1   1   846   1014   1   1   1   1   1   1   1   1   1   1   1   744
            744   1   1   1   1   1   1   1   1   1   1   1   1   1   1   1   1   1   759   1   1   1   1   1   1   1   1   1   1   1   1   1   1   1   1   1   1   1   1   1   1   1   1   1   1   1   1   1   1   744
            744   1   1   1   717   800   800   800   800   800   800   800   800   800   800   800   717   1   1   1   1   717   800   800   912   913   800   800   800   717   225   1   1   1   962   1   1   225   1   1   1   1   1   1   912   913   1   1   1   744
            744   1   1   1   744   1   1   1   1   1   1   1   1   1   1   1   1   1   225   1   1   1   1   1   939   940   1   1   1   744   1   1   1   1   1   1   1   1   1   1   1   1   1   1   939   940   1   1   1   744
            744   1   1   1   744   1   1   1   1   1   193   194   195   786   1   1   1   1   1   1   1   1   1   1   1   1   1   1   1   744   1   1   1   1   1   1   1   1   1   1   1   1   1   1   1   1   1   1   1   744
            744   1   1   1   744   1   907   1   1   1   220   221   222   1   1   1   1   1   1   1   1   1   1   1   1   1   1   1   1   744   1   1   907   1   1   1   1   225   1   1   1   1   1   1   1   1   1   907   1   744
            744   1   1   1   744   1   1   1   225   1   247   248   249   1   1   1   1   1   1   1   1   717   800   800   800   800   800   800   800   717   1   1   717   1   1   1   1   1   1   1   1   1   1   1   1   1   1   1   1   744
            744   1   1   1   744   1   1   1   1   1   1   1   1   1   1   1   1   1   1   1   1   1   1   1   1   1   1   1   1   744   1   1   744   1   1   1   1   1   1   1   1   1   1   1   1   225   1   1   1   744
            744   1   1   1   744   1   1   1   1   1   907   1   1   1   1   1   710   1   1   1   1   1   1   1   1   1   1   968   969   744   1   1   744   225   1   1   1   1   1   1   1   1   1   1   1   1   1   1   1   744
            744   1   1   1   744   1   1   1   1   1   1   1   1   1   1   1   1   1   1   225   1   1   1   1   1   1   1   995   996   744   1   1   744   1   1   1   991   1   1   1   1   968   969   1   1   1   1   1   1   744
            744   1   1   1   717   800   800   800   800   800   800   800   800   800   717   1   1   1   1   1   1   1   1   1   225   1   1   1   1   744   1   1   744   1   1   1   1   1   1   1   1   995   996   1   1   1   1   963   1   744
            744   1   225   1   1   1   1   1   1   1   1   1   1   1   1   1   1   1   1   1   1   1   1   1   1   1   1   1   1   744   1   1   744   963   1   1   1   1   1   1   1   1   1   1   1   1   1   1   1   744
            744   1   1   1   1   1   1   1   1   1   1   1   1   1   1   1   1   1   1   1   1   1   1   1   912   913   1   1   1   744   1   1   744   786   912   913   1   1   1   1   1   1   1   1   912   913   1   1   1   744
            744   1   1   1   717   800   800   800   800   800   800   800   800   800   717   1   1   717   800   800   800   800   800   800   939   940   800   800   800   717   1   1   744   1   939   940   1   1   1   1   1   1   1   1   939   940   1   1   1   744
            744   1   1   1   744   1   1   744   1   1   1   1   1   1   744   1   1   744   786   1   1   1   1   1   1   1   1   1   1   1   1   1   744   1   1   1   1   1   1   1   1   1   1   1   1   1   1   1   225   744
            744   1   1   1   744   1   1   744   1   1   1   1   1   1   744   1   1   744   1   1   1   1   1   1   1   1   1   1   1   1   1   1   744   1   1   1   1   1   1   1   1   1   1   1   1   1   1   1   1   744
            744   1   1   1   744   1   207   717   800   800   800   800   800   800   717   1   1   717   800   800   800   717   1   1   717   1   1   1   1   1   1   1   718   800   800   800   800   800   800   717   131   131   131   717   800   800   800   800   800   717
            744   225   1   1   744   1   1   1   1   1   1   1   1   1   1   1   1   1   1   1   1   207   1   1   744   1   1   1   1   1   1   1   744   1   1   1   1   1   1   1   1   4   1   1   1   1   1   1   1   744
            744   1   1   1   744   1   1   717   800   800   800   800   800   717   1   1   1   1   1   1   1   1   1   1   744   1   1   1   1   1   1   1   744   1   1   1   1   1   1   1   1   31   1   1   1   1   1   1   1   744
            744   1   1   1   744   1   1   1   1   1   1   1   1   744   1   1   717   717   800   800   800   717   1   1   717   1   1   193   194   195   1   1   744   1   1   1   1   1   1   1   1   31   1   1   1   1   1   1   1   744
            744   1   1   1   744   1   1   1   1   1   1   1   786   744   1   1   744   1   1   1   1   1   1   1   744   1   1   220   221   222   1   1   744   1   1   1   1   1   1   1   1   31   1   1   1   1   1   1   1   744
            744   1   1   1   717   800   800   800   800   800   800   800   800   717   1   1   717   800   800   800   800   800   717   800   717   1   1   247   248   249   1   1   744   1   1   1   1   1   1   1   1   31   1   1   1   1   1   1   1   744
            744   1   1   1   1   1   1   1   1   1   1   1   1   1   1   1   1   1   1   1   1   1   1   1   1   1   1   1   1   1   1   1   744   1   1   1   278   360   279   279   279   848   279   279   279   279   280   1   1   744
            744   1   1   207   717   800   800   800   800   800   800   800   800   800   800   800   800   800   800   800   800   800   717   207   1   1   1   1   1   1   1   1   744   1   1   1   305   306   306   306   306   848   306   306   306   306   307   1   1   744
            744   1   1   1   744   1   1   1   1   1   1   1   1   1   1   1   1   1   1   1   1   1   744   1   1   717   1   1   1   717   1   1   744   1   1   1   305   306   471   495   495   848   495   576   470   306   307   1   1   744
            744   1   1   1   717   800   800   800   800   800   800   800   717   1   1   717   800   800   800   717   1   1   744   1   1   744   1   1   1   744   1   1   744   1   1   1   305   306   388   759   56   55   55   759   386   306   307   1   1   744
            744   1   1   1   1   1   1   1   1   1   1   1   1   1   1   1   1   1   1   744   1   786   744   1   1   744   1   1   786   744   1   1   744   1   1   1   305   306   388   1   1   2   1   2   386   306   307   1   1   744
            744   1   1   1   717   800   800   800   800   800   800   800   800   800   800   800   800   800   800   800   800   800   717   1   1   717   722   722   722   717   1   1   744   1   1   1   305   306   388   1   28   29   28   29   386   306   307   1   1   744
            744   1   1   1   1   1   1   1   1   1   1   1   1   1   1   1   1   1   1   1   1   1   1   1   1   1   1   1   1   1   1   1   744   1   1   1   305   306   388   759   55   56   55   759   386   306   307   1   1   744
            717   722   722   722   722   722   722   722   722   722   722   722   722   722   722   722   722   722   722   722   722   722   717   722   722   722   722   722   722   722   722   722   717   722   722   722   722   722   722   722   722   722   722   722   722   722   722   722   722   717